SO      ./texture/wall_2.xpm      
       WE      ./texture/wall_3.xpm     
     NO      ./texture/wall_1.xpm     
     R  1920    1080   

  EA      ./texture/wall_4.xpm
    S     ./texture/sprite_1.xpm
F    66,  49,   137      
C    23,114,69



           1
11111111111211111111111111111
10000000001100000000000000001         111111111
10110000011100000000000010001         111111111
10010222222222000000000010001    
10110000011100000000000010001  
10000000001100000111011110001             
11110111111111011100000010001          
11110111111111011101010010001
11000000110101011100000010001
10000020000000001100000010001
10000000000000001101010010001
11000000110101000000000000001
11110111110101000000000000001
10000200001100000100200010001
10000000000000001010000001001
10000000001000010001010001001
10000000001101000000N00200001
12000000000100000001210000001
11111111111111111111111111111