     SO      ./texture/wall_4.xpm      
       WE      ./texture/wall_4.xpm     
     NO      ./texture/wall_4.xpm     
     R  1500    1500      

    EA      ./texture/wall_4.xpm
    S     ./texture/sprite_1.xpm
F    150, 0, 24     
C    150, 0, 24



111111
102S21
102021
102021
102021
102021
102021
102021
102021
102021
102021
102021
102021
102021
102021
102021
102021
102021
102021
102021
102021
102021
102021
102021
102021
102021
102021
102021
102021
102021
102021
102021
102021
102021
102021
102021
102021
102021
102021
102021
102021
102021
102021
102021
102021
102021
102021
102021
102021
102021
102021
102021
102021
102021
102021
102021
102021
102021
102021
102021
102021
102021
102021
102021
102021
102021
102021
102021
102021
102021
102021
102021
102021
102021
102021
102021
102021
102021
102021
102021
102021
102021
102021
102021
102021
102021
102021
102021
102021
102021
102021
102021
102021
102021
102021
102021
102021
102021
102021
102021
102021
102021
102021
102021
102021
102021
102021
102021
102021
102021
102021
102021
102021
102021
102021
102021
102021
102021
102021
102021
102021
102021
102021
102021
102021
102021
102021
102021
102021
102021
102021
102021
102021
102021
102021
102021
102021
102021
102021
102021
102021
102021
102021
102021
102021
102021
102021
102021
102021
102021
102021
102021
102021
102021
102021
102021
102021
102021
102021
102021
102021
102021
102021
102021
102021
102021
102021
102021
102021
102021
102021
102021
102021
102021
102021
102021
102021
102021
102021
102021
102021
102021
102021
102021
102021
102021
102021
102021
102021
102021
102021
102021
102021
102021
102021
102021
102021
102021
102021
102021
102021
102021
102021
102021
102021
102021
102021
102021
102021
102021
102021
102021
102021
102021
102021
102021
102021
102021
102021
102021
102021
102021
102021
102021
102021
102021
102021
102021
102021
102021
102021
102021
102021
102021
102021
102021
102021
102021
102021
102021
102021
102021
102021
102021
102021
102021
102021
102021
102021
102021
102021
102021
102021
102021
102021
102021
102021
102021
102021
102021
102021
102021
102021
102021
102021
102021
102021
102021
102021
102021
102021
102021
102021
102021
102021
102021
102021
102021
102021
102021
102021
102021
102021
102021
102021
102021
102021
102021
102021
102021
102021
102021
102021
102021
102021
102021
102021
102021
102021
102021
102021
102021
102021
102021
102021
102021
102021
102021
102021
102021
102021
102021
102021
102021
102021
102021
102021
102021
102021
102021
102021
102021
102021
102021
102021
102021
102021
102021
102021
102021
102021
102021
102021
102021
102021
102021
102021
102021
102021
102021
102021
102021
102021
102021
102021
102021
102021
102021
102021
102021
102021
102021
102021
102021
102021
102021
102021
102021
102021
102021
102021
102021
102021
102021
102021
102021
102021
102021
102021
102021
102021
102021
102021
102021
102021
102021
102021
102021
102021
102021
102021
102021
102021
102021
102021
102021
102021
102021
102021
102021
102021
102021
102021
102021
102021
102021
102021
102021
102021
102021
102021
102021
102021
102021
102021
102021
102021
102021
102021
102021
102021
102021
102021
102021
102021
102021
102021
102021
102021
102021
102021
102021
102021
102021
102021
102021
102021
102021
102021
102021
102021
102021
102021
102021
102021
102021
102021
102021
102021
102021
102021
102021
102021
102021
102021
102021
102021
102021
102021
102021
102021
102021
102021
102021
102021
102021
102021
102021
102021
111111